"","player_name","season","team","games","total_carries","total_rushing_yards","total_rushing_tds","rushing_yards_per_carry","rushing_yards_per_game","total_rushing_epa","rush_epa_per_att","avg_efficiency","total_targets","total_receptions","total_receiving_yards","total_receiving_tds","catch_rate","total_touches","total_scrimmage_yards","total_scrimmage_tds","scrimmage_yards_per_game","total_fantasy_points","fantasy_points_per_game"
"1","A.Abdullah",2022,"LV",13,4,20,0,5,1.53846153846154,-0.311809271416516,-0.0779523178541289,NA,32,25,211,1,78.125,29,231,1,17.7692307692308,54.1,4.16153846153846
"2","A.Abdullah",2023,"LV",16,15,89,0,5.93333333333333,5.5625,2.60262565822679,0.173508377215119,NA,24,19,131,0,79.1666666666667,34,220,0,13.75,41,2.5625
"3","A.Abdullah",2024,"LV",13,66,311,2,4.71212121212121,23.9230769230769,-7.58153822137156,-0.114871791232902,3.19297324414716,47,40,261,3,85.1063829787234,106,572,5,44,125.2,9.63076923076923
"4","A.Armah",2023,"WAS",3,0,0,0,NA,0,0,NA,NA,3,3,13,0,100,3,13,0,4.33333333333333,4.3,1.43333333333333
"5","A.Dillon",2022,"GB",17,186,770,7,4.13978494623656,45.2941176470588,2.27966807100254,0.0122562799516265,3.92816443980913,43,28,206,0,65.1162790697674,214,976,7,57.4117647058824,167.6,9.85882352941177
"6","A.Dillon",2023,"GB",15,178,613,2,3.4438202247191,40.8666666666667,-23.4962760458746,-0.13200155081952,4.86396238564517,28,22,223,0,78.5714285714286,200,836,2,55.7333333333333,117.6,7.84
"7","A.Ekeler",2022,"LAC",18,217,950,15,4.3778801843318,52.7777777777778,-3.48850600757075,-0.0160760645510173,4.40406588852267,131,109,730,5,83.206106870229,326,1680,20,93.3333333333333,391,21.7222222222222
"8","A.Ekeler",2023,"LAC",14,179,628,5,3.50837988826816,44.8571428571429,-41.1234789901547,-0.22974010609025,5.28131296163675,74,51,436,1,68.9189189189189,230,1064,6,76,185.4,13.2428571428571
"9","A.Ekeler",2024,"WAS",15,99,456,4,4.60606060606061,30.4,0.743692977530044,0.00751205027808125,4.24640151515151,56,47,450,0,83.9285714285714,146,906,4,60.4,159.6,10.64
"10","A.Estime",2024,"DEN",13,76,310,2,4.07894736842105,23.8461538461538,-7.42971777551686,-0.0977594444146955,4.36155937846837,5,5,27,0,100,81,337,2,25.9230769230769,48.7,3.74615384615385
"11","A.Gibson",2022,"WAS",15,149,546,3,3.66442953020134,36.4,-15.689292970687,-0.105297268259644,4.56213562765414,58,46,353,2,79.3103448275862,195,899,5,59.9333333333333,165.9,11.06
"12","A.Gibson",2023,"WAS",16,65,265,1,4.07692307692308,16.5625,-6.73583069333108,-0.103628164512786,4.34428571428571,59,48,389,2,81.3559322033898,113,654,3,40.875,127.4,7.9625
"13","A.Gibson",2024,"NE",17,120,538,1,4.48333333333333,31.6470588235294,-10.6508576496562,-0.0887571470804687,5.0079534761701,29,23,206,0,79.3103448275862,143,744,1,43.7647058823529,103.4,6.08235294117647
"14","A.Jones",2022,"GB",17,213,1121,2,5.26291079812207,65.9411764705882,12.0849981251231,0.0567370803996389,4.00179892322643,72,59,395,5,81.9444444444444,272,1516,7,89.1764705882353,248.6,14.6235294117647
"15","A.Jones",2023,"GB",13,181,882,5,4.87292817679558,67.8461538461538,10.6532560350897,0.058857768149667,3.77131431532439,50,34,254,1,68,215,1136,6,87.3846153846154,183.6,14.1230769230769
"16","A.Jones",2024,"MIN",18,268,1186,5,4.42537313432836,65.8888888888889,-16.4632265690085,-0.06142994988436,4.05665261509535,68,54,420,2,79.4117647058823,322,1606,7,89.2222222222222,250.6,13.9222222222222
"17","A.Kamara",2022,"NO",15,223,897,2,4.02242152466368,59.8,-41.0502381516271,-0.184081785433306,4.02540571764864,77,57,490,2,74.025974025974,280,1387,4,92.4666666666667,211.7,14.1133333333333
"18","A.Kamara",2023,"NO",13,180,694,5,3.85555555555556,53.3846153846154,-3.14502008270938,-0.0174723337928299,4.00603748490344,86,75,466,1,87.2093023255814,255,1160,6,89.2307692307692,233,17.9230769230769
"19","A.Kamara",2024,"NO",14,228,950,6,4.16666666666667,67.8571428571429,-18.174864595851,-0.0797143184028555,4.66965032543803,89,68,543,2,76.4044943820225,296,1493,8,106.642857142857,265.3,18.95
"20","A.Mattison",2022,"MIN",18,74,283,5,3.82432432432432,15.7222222222222,0.382584990555188,0.00517006743993497,2.92851851851852,19,16,93,1,84.2105263157895,90,376,6,20.8888888888889,89.6,4.97777777777778
"21","A.Mattison",2023,"MIN",16,180,700,0,3.88888888888889,43.75,-31.7409543032685,-0.176338635018158,4.32903029227084,44,30,192,3,68.1818181818182,210,892,3,55.75,133.2,8.325
"22","A.Mattison",2024,"LV",14,132,420,4,3.18181818181818,30,-30.8919976790078,-0.234030285447029,5.88255468105926,48,36,294,1,75,168,714,5,51,137.4,9.81428571428571
"23","A.McFarland",2022,"PIT",1,6,30,0,5,30,0.771915463672485,0.128652577278748,NA,2,2,11,0,100,8,41,0,41,6.1,6.1
"24","A.McFarland",2023,"PIT",1,0,0,0,NA,0,0,NA,NA,2,2,11,0,100,2,11,0,11,3.1,3.1
"25","A.Shampklin",2024,"PIT",3,6,17,0,2.83333333333333,5.66666666666667,-2.41446994639547,-0.402411657732578,NA,0,0,0,0,NA,6,17,0,5.66666666666667,1.7,0.566666666666667
"26","A.Williams",2022,"ATL",14,22,109,1,4.95454545454545,7.78571428571429,0.220577496336773,0.0100262498334897,NA,14,13,61,0,92.8571428571429,35,170,1,12.1428571428571,36,2.57142857142857
"27","B.Allen",2024,"NYJ",17,92,334,2,3.6304347826087,19.6470588235294,-7.61642359342659,-0.0827872129720281,4.06444194855532,27,19,148,1,70.3703703703704,111,482,3,28.3529411764706,85.2,5.01176470588235
"28","B.Bolden",2022,"LV",8,17,66,0,3.88235294117647,8.25,-6.28464577894192,-0.369685045820113,NA,9,9,57,1,100,26,123,1,15.375,27.3,3.4125
"29","B.Bolden",2023,"LV",3,4,31,1,7.75,10.3333333333333,3.67902799433796,0.919756998584489,NA,0,0,0,0,NA,4,31,1,10.3333333333333,11.1,3.7
"30","B.Brooks",2024,"HOU",1,1,2,0,2,2,-0.336250451859087,-0.336250451859087,NA,0,0,0,0,NA,1,2,0,2,0.2,0.2
"31","B.Corum",2024,"LA",14,58,207,0,3.56896551724138,14.7857142857143,-9.74375213630265,-0.167995726487977,NA,8,7,58,0,87.5,65,265,0,18.9285714285714,33.5,2.39285714285714
"32","B.Hall",2022,"NYJ",7,80,463,4,5.7875,66.1428571428571,13.8891096828738,0.173613871035923,3.55251143679956,31,19,218,1,61.2903225806452,99,681,5,97.2857142857143,115.1,16.4428571428571
"33","B.Hall",2023,"NYJ",17,223,994,5,4.45739910313901,58.4705882352941,-21.7597802430493,-0.0975774898791447,5.74936281791529,95,76,591,4,80,299,1585,9,93.2352941176471,290.5,17.0882352941176
"34","B.Hall",2024,"NYJ",16,209,876,5,4.19138755980861,54.75,-22.0187637538433,-0.10535293662126,5.75045234784902,76,57,483,3,75,266,1359,8,84.9375,240.9,15.05625
"35","B.Irving",2024,"TB",18,224,1199,8,5.35267857142857,66.6111111111111,19.8081395053288,0.0884291942202179,3.40938228869372,54,49,398,1,90.7407407407407,273,1597,9,88.7222222222222,260.7,14.4833333333333
"36","B.Robinson",2022,"WAS",12,205,797,2,3.88780487804878,66.4166666666667,-6.23539711959893,-0.0304165713151167,4.16491409483501,12,9,60,1,75,214,857,3,71.4166666666667,112.7,9.39166666666667
"37","B.Robinson",2023,"ATL",17,214,976,4,4.5607476635514,57.4117647058824,-26.7062713821204,-0.124795660664114,4.74176499496346,86,58,487,4,67.4418604651163,272,1463,8,86.0588235294118,246.3,14.4882352941176
"38","B.Robinson",2023,"WAS",15,178,733,5,4.11797752808989,48.8666666666667,-22.1895465999836,-0.124660374157211,3.87147524535807,43,36,368,4,83.7209302325581,214,1101,9,73.4,198.1,13.2066666666667
"39","B.Robinson",2024,"ATL",17,304,1456,14,4.78947368421053,85.6470588235294,16.8835396067896,0.0555379592328607,4.41747068575912,72,61,431,1,84.7222222222222,365,1887,15,111,341.7,20.1
"40","B.Robinson",2024,"WAS",17,223,928,10,4.16143497757847,54.5882352941176,-11.052836564882,-0.0495642895286187,4.10717922074396,30,24,181,0,80,247,1109,10,65.2352941176471,190.9,11.2294117647059
"41","B.Scott",2022,"PHI",16,69,278,5,4.02898550724638,17.375,-1.13787135912571,-0.0164908892626915,NA,7,6,24,0,85.7142857142857,75,302,5,18.875,66.2,4.1375
"42","B.Scott",2023,"PHI",10,20,86,0,4.3,8.6,-3.17410284868674,-0.158705142434337,NA,6,4,52,0,66.6666666666667,24,138,0,13.8,17.8,1.78
"43","B.Snell",2022,"PIT",3,20,90,1,4.5,30,4.33043405856006,0.216521702928003,3.16209677419355,2,2,17,0,100,22,107,1,35.6666666666667,18.7,6.23333333333333
"44","B.Watson",2024,"DEN",1,4,10,0,2.5,10,-0.179672391968779,-0.0449180979921948,NA,2,1,13,0,50,5,23,0,23,3.3,3.3
"45","C.Akers",2022,"LA",15,188,786,7,4.18085106382979,52.4,-13.2471754593134,-0.0704636992516672,4.06005487990522,18,13,117,0,72.2222222222222,201,903,7,60.2,141.3,9.42
"46","C.Akers",2023,"LA",1,22,29,1,1.31818181818182,29,-2.69685591459112,-0.122584359754142,12.1131034482759,0,0,0,0,NA,22,29,1,29,8.9,8.9
"47","C.Akers",2023,"MIN",6,38,138,1,3.63157894736842,23,-2.09102800012217,-0.055027052634794,4.94387096774194,12,11,70,0,91.6666666666667,49,208,1,34.6666666666667,37.8,6.3
"48","C.Akers",2024,"HOU",5,40,147,1,3.675,29.4,-12.17120414495,-0.304280103623751,5.61358490566038,7,4,16,1,57.1428571428571,44,163,2,32.6,30.3,6.06
"49","C.Akers",2024,"MIN",11,69,336,1,4.8695652173913,30.5454545454545,-6.70227958774194,-0.0971344867788687,5.6178447368421,11,10,52,2,90.9090909090909,79,388,3,35.2727272727273,66.8,6.07272727272727
"50","C.Brooks",2023,"MIA",3,19,106,0,5.57894736842105,35.3333333333333,-3.39220510114683,-0.178537110586675,NA,0,0,0,0,NA,19,106,0,35.3333333333333,10.6,3.53333333333333
"51","C.Brooks",2024,"GB",12,36,183,1,5.08333333333333,15.25,4.7882587546025,0.133007187627847,NA,16,13,78,0,81.25,49,261,1,21.75,45.1,3.75833333333333
"52","C.Brown",2023,"CIN",10,44,179,0,4.06818181818182,17.9,-9.0110161552813,-0.204795821710939,4.80790697674419,15,14,156,1,93.3333333333333,58,335,1,33.5,53.5,5.35
"53","C.Brown",2024,"CIN",16,229,990,7,4.32314410480349,61.875,-5.85863272827405,-0.0255835490317644,4.04331949524157,65,54,360,4,83.0769230769231,283,1350,11,84.375,255,15.9375
"54","C.Clement",2022,"ARI",4,15,55,1,3.66666666666667,13.75,-0.753288354200777,-0.0502192236133851,NA,7,5,54,0,71.4285714285714,20,109,1,27.25,21.9,5.475
"55","C.Collier",2024,"LV",2,5,12,0,2.4,6,-3.00471946189646,-0.600943892379291,NA,2,1,-4,0,50,6,8,0,4,1.8,0.9
"56","C.Edmonds",2022,"DEN",5,26,125,0,4.80769230769231,25,-2.69303358526668,-0.103578214817949,NA,7,6,61,0,85.7142857142857,32,186,0,37.2,24.6,4.92
"57","C.Edmonds",2022,"MIA",8,42,120,2,2.85714285714286,15,-13.012938493368,-0.309831868889714,7.2684,17,10,96,1,58.8235294117647,52,216,3,27,49.6,6.2
"58","C.Edmonds",2023,"TB",15,60,207,0,3.45,13.8,-9.85857114053073,-0.164309519008846,6.1088,21,17,107,0,80.952380952381,77,314,0,20.9333333333333,48.4,3.22666666666667
"59","C.Edwards-Helaire",2022,"KC",10,71,302,3,4.25352112676056,30.2,1.99692229188804,0.0281256660829301,3.59978260869565,23,17,151,3,73.9130434782609,88,453,6,45.3,98.3,9.83
"60","C.Edwards-Helaire",2023,"KC",19,81,276,1,3.40740740740741,14.5263157894737,-17.6729946369014,-0.218185118974092,4.56998773598774,26,21,195,1,80.7692307692308,102,471,2,24.7894736842105,78.1,4.11052631578947
"61","C.Edwards-Helaire",2024,"NO",2,13,46,0,3.53846153846154,23,-1.9589731086744,-0.1506902391288,NA,5,3,24,0,60,16,70,0,35,10,5
"62","C.Evans",2022,"CIN",4,0,0,0,NA,0,0,NA,NA,4,3,38,1,75,3,38,1,9.5,12.8,3.2
"63","C.Evans",2023,"CIN",1,2,12,0,6,12,-0.65153782418929,-0.325768912094645,NA,1,1,-1,0,100,3,11,0,11,2.1,2.1
"64","C.Hubbard",2022,"CAR",12,95,466,2,4.90526315789474,38.8333333333333,1.79318459826909,0.018875627350201,3.38885875741963,17,14,171,0,82.3529411764706,109,637,2,53.0833333333333,89.7,7.475
"65","C.Hubbard",2023,"CAR",17,238,902,5,3.78991596638655,53.0588235294118,-21.5159644468484,-0.0904032119615478,4.08936649825566,44,39,233,0,88.6363636363636,277,1135,5,66.7647058823529,182.5,10.7352941176471
"66","C.Hubbard",2024,"CAR",15,250,1195,10,4.78,79.6666666666667,9.69687744641844,0.0387875097856738,3.56523668307625,54,43,171,1,79.6296296296296,293,1366,11,91.0666666666667,241.6,16.1066666666667
"67","C.Huntley",2022,"ATL",12,76,366,1,4.81578947368421,30.5,3.98099746863591,0.0523815456399461,3.56826325510648,2,2,3,0,100,78,369,1,30.75,44.9,3.74166666666667
"68","C.McCaffrey",2022,"CAR",6,85,393,2,4.62352941176471,65.5,1.99324004077863,0.0234498828326897,3.50177782083409,43,33,277,1,76.7441860465116,118,670,3,111.666666666667,118,19.6666666666667
"69","C.McCaffrey",2022,"SF",14,199,984,8,4.94472361809045,70.2857142857143,6.84578840892367,0.0344009467785109,4.03251317129237,79,64,525,5,81.0126582278481,263,1509,13,107.785714285714,298.26,21.3042857142857
"70","C.McCaffrey",2023,"SF",19,331,1727,18,5.21752265861027,90.8947368421053,12.0509664340352,0.0364077535771457,3.83543484222438,108,86,716,8,79.6296296296296,417,2443,26,128.578947368421,480.3,25.2789473684211
"71","C.McCaffrey",2024,"SF",4,50,202,0,4.04,50.5,-2.89182955757133,-0.0578365911514265,5.44723445467014,19,15,146,0,78.9473684210526,65,348,0,87,47.8,11.95
"72","C.Patterson",2022,"ATL",13,144,695,8,4.82638888888889,53.4615384615385,-0.252170304221885,-0.00175118266820754,3.98060656745088,31,21,122,0,67.741935483871,165,817,8,62.8461538461538,154.7,11.9
"73","C.Patterson",2023,"ATL",12,50,181,0,3.62,15.0833333333333,-7.98226873380178,-0.159645374676036,3.90946428571429,12,9,38,1,75,59,219,1,18.25,36.9,3.075
"74","C.Patterson",2024,"PIT",13,32,135,0,4.21875,10.3846153846154,-7.84534724344177,-0.245167101357555,NA,14,12,80,1,85.7142857142857,44,215,1,16.5384615384615,37.5,2.88461538461539
"75","C.Reynolds",2022,"DET",6,23,102,0,4.43478260869565,17,-4.25025906867813,-0.184793872551223,NA,10,9,116,0,90,32,218,0,36.3333333333333,30.8,5.13333333333333
"76","C.Reynolds",2023,"DET",7,42,180,2,4.28571428571429,25.7142857142857,-2.45146162845776,-0.0583681340108991,6.63985585585586,5,5,47,0,100,47,227,2,32.4285714285714,37.7,5.38571428571429
"77","C.Reynolds",2024,"DET",7,31,139,0,4.48387096774194,19.8571428571429,-4.86852235585684,-0.157049108253446,NA,5,3,40,0,60,34,179,0,25.5714285714286,20.9,2.98571428571429
"78","C.Rodriguez",2023,"WAS",8,51,247,2,4.84313725490196,30.875,-3.48416020427248,-0.0683168667504409,3.42133004926108,2,2,12,0,100,53,259,2,32.375,37.9,4.7375
"79","C.Rodriguez",2024,"WAS",6,35,173,2,4.94285714285714,28.8333333333333,7.94025240946212,0.226864354556061,2.59740180032733,1,1,12,0,100,36,185,2,30.8333333333333,31.5,5.25
"80","C.Schrader",2024,"LA",1,1,3,0,3,3,-0.320892589399591,-0.320892589399591,NA,1,1,6,0,100,2,9,0,9,1.9,1.9
"81","C.Steele",2024,"KC",12,56,183,0,3.26785714285714,15.25,-11.9836104627345,-0.213993043977402,2.92652777777778,11,7,26,0,63.6363636363636,63,209,0,17.4166666666667,23.9,1.99166666666667
"82","D.Achane",2023,"MIA",12,109,809,8,7.42201834862385,67.4166666666667,32.3529554097063,0.296816104676205,3.30594078816364,43,30,218,3,69.7674418604651,139,1027,11,85.5833333333333,196.7,16.3916666666667
"83","D.Achane",2024,"MIA",17,203,907,6,4.4679802955665,53.3529411764706,-11.2816310102353,-0.0555745369962329,5.06301291272561,87,78,592,6,89.6551724137931,281,1499,12,88.1764705882353,299.9,17.6411764705882
"84","D.Cook",2022,"MIN",18,279,1233,8,4.41935483870968,68.5,-49.506622819661,-0.177443092543588,4.43263287579737,63,45,305,2,71.4285714285714,324,1538,10,85.4444444444444,250.8,13.9333333333333
"85","D.Cook",2023,"BAL",1,8,23,0,2.875,23,-1.45699672916259,-0.182124591145324,NA,0,0,0,0,NA,8,23,0,23,2.3,2.3
"86","D.Cook",2023,"NYJ",14,67,214,0,3.19402985074627,15.2857142857143,-24.8627181499614,-0.371085345521812,5.75878787878788,20,15,78,0,75,82,292,0,20.8571428571429,40.2,2.87142857142857
"87","D.Cook",2024,"DAL",2,8,20,0,2.5,10,-2.66215546766762,-0.332769433458452,NA,1,1,10,0,100,9,30,0,15,4,2
"88","D.Dallas",2022,"SEA",12,41,199,0,4.85365853658537,16.5833333333333,1.53082483552862,0.0373371911104541,4.2372972972973,19,17,126,0,89.4736842105263,58,325,0,27.0833333333333,47.5,3.95833333333333
"89","D.Dallas",2023,"SEA",10,10,36,0,3.6,3.6,0.156264331133571,0.015626433113357,NA,9,6,26,0,66.6666666666667,16,62,0,6.2,12.2,1.22
"90","D.Dallas",2024,"ARI",7,9,49,0,5.44444444444444,7,1.28107167757116,0.142341297507907,NA,3,3,11,1,100,12,60,1,8.57142857142857,21,3
"91","D.Evans",2022,"CHI",3,14,64,0,4.57142857142857,21.3333333333333,2.96236367704114,0.211597405502939,NA,1,1,33,0,100,15,97,0,32.3333333333333,10.7,3.56666666666667
"92","D.Evans",2023,"CHI",5,30,105,1,3.5,21,-0.00531587716251014,-0.000177195905417005,5.8325,12,7,49,0,58.3333333333333,37,154,1,30.8,28.4,5.68
"93","D.Evans",2023,"MIA",1,2,16,0,8,16,0.609161459142342,0.304580729571171,NA,0,0,0,0,NA,2,16,0,16,1.6,1.6
"94","D.Evans",2024,"CHI",1,3,3,0,1,3,-1.29481282713823,-0.431604275712743,NA,0,0,0,0,NA,3,3,0,3,0.3,0.3
"95","D.Felton",2022,"CLE",4,1,-4,0,-4,-1,-1.29092040879186,-1.29092040879186,NA,4,2,8,0,50,3,4,0,1,2.4,0.6
"96","D.Foreman",2022,"CAR",16,203,914,5,4.50246305418719,57.125,2.98204335824736,0.0146898687598392,4.58960690354974,9,5,26,0,55.5555555555556,208,940,5,58.75,131,8.1875
"97","D.Foreman",2023,"CHI",9,109,425,4,3.89908256880734,47.2222222222222,-4.14315042519593,-0.0380105543595957,3.50641966234862,16,11,77,1,68.75,120,502,5,55.7777777777778,91.2,10.1333333333333
"98","D.Foreman",2024,"CLE",10,71,232,0,3.26760563380282,23.2,-24.1594711056096,-0.340274240924078,4.34531608880111,8,6,54,0,75,77,286,0,28.6,32.6,3.26
"99","D.Gore",2023,"WAS",2,3,26,0,8.66666666666667,13,-1.32363200120744,-0.441210667069148,NA,0,0,0,0,NA,3,26,0,13,2.6,1.3
"100","D.Harris",2022,"NE",11,106,462,3,4.35849056603774,42,-3.71608092816314,-0.035057367246822,3.8452014534137,23,17,97,0,73.9130434782609,123,559,3,50.8181818181818,90.9,8.26363636363637
"101","D.Harris",2023,"BUF",6,23,94,1,4.08695652173913,15.6666666666667,2.17426049790811,0.0945330651264395,NA,2,2,16,0,100,25,110,1,18.3333333333333,19,3.16666666666667
"102","D.Henderson",2022,"LA",10,70,283,3,4.04285714285714,28.3,1.44125769513403,0.0205893956447718,3.42766198222238,22,17,102,0,77.2727272727273,87,385,3,38.5,73.5,7.35
"103","D.Henderson",2023,"LA",4,46,112,2,2.43478260869565,28,-11.786323133565,-0.256224415947066,5.64974440331394,14,10,103,0,71.4285714285714,56,215,2,53.75,43.5,10.875
"104","D.Henry",2022,"TEN",16,349,1538,13,4.40687679083095,96.125,-22.3112961681327,-0.063929215381469,4.31677501961162,41,33,398,0,80.4878048780488,382,1936,13,121,302.76,18.9225
"105","D.Henry",2023,"TEN",17,280,1167,12,4.16785714285714,68.6470588235294,-2.09850315903817,-0.00749465413942202,5.3489057076903,36,28,214,0,77.7777777777778,308,1381,12,81.2352941176471,246.66,14.5094117647059
"106","D.Henry",2024,"BAL",19,367,2191,19,5.9700272479564,115.315789473684,47.4913418960885,0.12940420135174,3.1925081365861,24,19,193,2,79.1666666666667,386,2384,21,125.473684210526,381.4,20.0736842105263
"107","D.Hilliard",2022,"TEN",11,22,145,0,6.59090909090909,13.1818181818182,0.607278296352364,0.0276035589251074,NA,26,21,177,4,80.7692307692308,43,322,4,29.2727272727273,77.2,7.01818181818182
"108","D.Jackson",2022,"IND",12,68,236,1,3.47058823529412,19.6666666666667,-15.6131862955828,-0.229605680817394,4.12154507355664,34,30,209,1,88.2352941176471,98,445,2,37.0833333333333,84.5,7.04166666666667
"109","D.Jackson",2023,"IND",1,13,14,0,1.07692307692308,14,-10.6969905669393,-0.822845428226104,10.4057142857143,6,5,14,0,83.3333333333333,18,28,0,28,3.8,3.8
"110","D.Jackson",2023,"NYG",1,1,2,0,2,2,-0.746223524562083,-0.746223524562083,NA,0,0,0,0,NA,1,2,0,2,0.2,0.2
"111","D.Johnson",2022,"BUF",1,2,4,0,2,4,-0.967043306212872,-0.483521653106436,NA,0,0,0,0,NA,2,4,0,4,0.4,0.4
"112","D.Johnson",2022,"CLE",3,4,17,0,4.25,5.66666666666667,-0.0639174141688272,-0.0159793535422068,NA,3,3,7,0,100,7,24,0,8,5.4,1.8
"113","D.Johnson",2022,"NO",4,12,24,0,2,6,-9.87764541426441,-0.823137117855367,NA,4,4,47,0,100,16,71,0,17.75,9.1,2.275
"114","D.Johnson",2023,"JAX",15,41,108,0,2.63414634146341,7.2,-13.3053339688936,-0.324520340704722,NA,12,10,140,0,83.3333333333333,51,248,0,16.5333333333333,34.8,2.32
"115","D.Johnson",2024,"JAX",12,32,143,0,4.46875,11.9166666666667,3.19850452046026,0.099953266264383,NA,19,12,96,0,63.1578947368421,44,239,0,19.9166666666667,35.9,2.99166666666667
"116","D.Laube",2024,"LV",1,1,0,0,0,0,-4.66817615873879,-4.66817615873879,NA,0,0,0,0,NA,1,0,0,0,-2,-2
"117","D.Montgomery",2022,"CHI",16,201,801,5,3.98507462686567,50.0625,-15.3133969494852,-0.0761860544750506,4.64646982331689,40,34,316,1,85,235,1117,6,69.8125,177.7,11.10625
"118","D.Montgomery",2023,"DET",17,258,1198,15,4.64341085271318,70.4705882352941,11.0840201255234,0.0429613183159823,3.5320569336871,31,22,162,0,70.9677419354839,280,1360,15,80,248,14.5882352941176
"119","D.Montgomery",2024,"DET",15,192,803,12,4.18229166666667,53.5333333333333,-8.48990764048532,-0.044218268960861,3.99365816991362,38,36,341,0,94.7368421052632,228,1144,12,76.2666666666667,225.32,15.0213333333333
"120","D.Ogunbowale",2022,"HOU",11,42,123,1,2.92857142857143,11.1818181818182,-6.2720837788881,-0.149335328068764,4.22090909090909,26,20,104,0,76.9230769230769,62,227,1,20.6363636363636,48.7,4.42727272727273
"121","D.Ogunbowale",2023,"HOU",7,10,42,0,4.2,6,-3.36661483106036,-0.336661483106036,NA,8,3,31,0,37.5,13,73,0,10.4285714285714,10.3,1.47142857142857
"122","D.Ogunbowale",2024,"HOU",17,32,126,0,3.9375,7.41176470588235,-7.77087260927736,-0.242839769039917,6.355,29,20,198,1,68.9655172413793,52,324,1,19.0588235294118,58.4,3.43529411764706
"123","D.Ozigbo",2022,"DEN",3,3,4,0,1.33333333333333,1.33333333333333,-1.50215048354585,-0.500716827848616,NA,1,1,3,0,100,4,7,0,2.33333333333333,1.7,0.566666666666667
"124","D.Ozigbo",2023,"DET",1,3,5,0,1.66666666666667,5,-1.60837490076665,-0.536124966922216,NA,1,1,8,0,100,4,13,0,13,2.3,2.3
"125","D.Pierce",2022,"HOU",13,220,939,4,4.26818181818182,72.2307692307692,-27.9403902780737,-0.127001773991244,4.86059642939299,39,30,165,1,76.9230769230769,250,1104,5,84.9230769230769,166.4,12.8
"126","D.Pierce",2023,"HOU",14,148,416,2,2.81081081081081,29.7142857142857,-42.7835608444851,-0.289078113814089,5.26113965741652,17,13,101,0,76.4705882352941,161,517,2,36.9285714285714,82.7,5.90714285714286
"127","D.Pierce",2024,"HOU",11,46,318,2,6.91304347826087,28.9090909090909,5.40441586321685,0.117487301374279,2.13852272727273,5,2,2,0,40,48,320,2,29.0909090909091,46,4.18181818181818
"128","D.Singletary",2022,"BUF",18,193,892,5,4.62176165803109,49.5555555555556,-15.2896057368198,-0.0792207551130559,3.32764766961685,60,43,317,1,71.6666666666667,236,1209,6,67.1666666666667,193.9,10.7722222222222
"129","D.Singletary",2023,"HOU",19,238,986,5,4.14285714285714,51.8947368421053,-21.2469027812699,-0.0892727007616381,4.08117727292561,47,38,245,0,80.8510638297872,276,1231,5,64.7894736842105,195.34,10.2810526315789
"130","D.Singletary",2024,"NYG",15,113,437,4,3.86725663716814,29.1333333333333,-11.1448167904699,-0.0986266972607956,5.24367702520334,24,21,119,0,87.5,134,556,4,37.0666666666667,96.6,6.44
"131","D.Swift",2022,"DET",14,99,542,5,5.47474747474747,38.7142857142857,5.51617491038692,0.0557189384887568,3.20975473302086,70,48,389,3,68.5714285714286,147,931,8,66.5,191.1,13.65
"132","D.Swift",2023,"PHI",17,239,1083,5,4.53138075313807,63.7058823529412,-0.500590910276906,-0.00209452263714187,4.05054378820506,53,43,246,1,81.1320754716981,282,1329,6,78.1764705882353,209.9,12.3470588235294
"133","D.Swift",2024,"CHI",17,253,959,6,3.7905138339921,56.4117647058824,-38.9268417686981,-0.153861034658886,5.37968681921539,52,42,386,0,80.7692307692308,295,1345,6,79.1176470588235,214.5,12.6176470588235
"134","D.Vaughn",2023,"DAL",6,23,40,0,1.73913043478261,6.66666666666667,-12.9092501658597,-0.561271746341726,NA,7,7,40,0,100,30,80,0,13.3333333333333,15,2.5
"135","D.Vaughn",2024,"DAL",5,17,70,0,4.11764705882353,14,-4.09176857437706,-0.240692269081003,NA,5,3,18,0,60,20,88,0,17.6,11.8,2.36
"136","D.Washington",2022,"NO",3,11,38,0,3.45454545454545,12.6666666666667,-3.34099882701412,-0.303727166092193,NA,1,1,7,0,100,12,45,0,15,5.5,1.83333333333333
"137","D.Williams",2022,"ARI",5,21,102,1,4.85714285714286,20.4,4.09910958161345,0.195195694362545,NA,8,4,9,0,50,25,111,1,22.2,21.1,4.22
"138","D.Williams",2022,"ATL",1,2,2,0,1,2,-1.12978465296328,-0.56489232648164,NA,0,0,0,0,NA,2,2,0,2,0.2,0.2
"139","D.Williams",2023,"ARI",3,11,43,0,3.90909090909091,14.3333333333333,-1.90821717237122,-0.173474288397384,NA,2,2,12,0,100,13,55,0,18.3333333333333,7.5,2.5
"140","E.Benjamin",2022,"ARI",9,70,299,2,4.27142857142857,33.2222222222222,0.68159008724615,0.00973700124637357,4.11499853113984,33,24,184,0,72.7272727272727,94,483,2,53.6666666666667,86.3,9.58888888888889
"141","E.Benjamin",2022,"HOU",1,3,1,0,0.333333333333333,1,-1.69661352213006,-0.565537840710022,NA,0,0,0,0,NA,3,1,0,1,0.1,0.1
"142","E.Benjamin",2022,"NO",2,4,13,0,3.25,6.5,-0.91061684692977,-0.227654211732442,NA,1,1,9,0,100,5,22,0,11,3.2,1.6
"143","E.Demercado",2023,"ARI",11,58,284,2,4.89655172413793,25.8181818181818,-5.29673494500512,-0.0913230162931917,3.6735860104136,30,21,119,0,70,79,403,2,36.6363636363636,73.3,6.66363636363636
"144","E.Demercado",2024,"ARI",13,24,223,1,9.29166666666667,17.1538461538462,12.3622012627535,0.515091719281394,NA,20,16,104,0,80,40,327,1,25.1538461538462,54.7,4.20769230769231
"145","E.Dotson",2023,"LAC",1,4,6,0,1.5,6,-3.19679077283945,-0.799197693209862,NA,2,2,13,0,100,6,19,0,19,3.9,3.9
"146","E.Elliott",2022,"DAL",17,254,929,12,3.65748031496063,54.6470588235294,-16.8731250067216,-0.0664296260107149,4.31503799500822,29,20,108,0,68.9655172413793,274,1037,12,61,195.7,11.5117647058824
"147","E.Elliott",2023,"NE",17,184,642,3,3.48913043478261,37.7647058823529,-27.2827446409823,-0.148275786092295,4.25114237770101,65,51,313,2,78.4615384615385,235,955,5,56.1764705882353,174.5,10.2647058823529
"148","E.Elliott",2024,"DAL",15,74,226,3,3.05405405405405,15.0666666666667,-16.1425326355093,-0.218142332912287,3.89366176470588,15,12,69,0,80,86,295,3,19.6666666666667,57.5,3.83333333333333
"149","E.Gray",2023,"NYG",5,17,48,0,2.82352941176471,9.6,-7.89402783877449,-0.464354578751441,6.744,7,6,22,0,85.7142857142857,23,70,0,14,13,2.6
"150","E.Gray",2024,"NYG",10,14,31,0,2.21428571428571,3.1,-16.0598759765853,-1.14713399832752,NA,11,10,82,0,90.9090909090909,24,113,0,11.3,19.3,1.93
"151","E.Hull",2023,"IND",1,1,1,0,1,1,-1.48695376177784,-1.48695376177784,NA,1,1,6,0,100,2,7,0,7,1.7,1.7
"152","E.Mitchell",2022,"SF",7,68,332,2,4.88235294117647,47.4285714285714,2.63566436552214,0.0387597700812079,3.59563780568407,7,5,32,1,71.4285714285714,73,364,3,52,59.4,8.48571428571429
"153","E.Mitchell",2023,"SF",13,81,296,3,3.65432098765432,22.7692307692308,-10.9980503308761,-0.135778399146619,4.09395314407814,8,6,14,0,75,87,310,3,23.8461538461538,55,4.23076923076923
"154","E.Wilson",2023,"GB",7,26,121,0,4.65384615384615,17.2857142857143,-2.25543230469339,-0.086747396334361,NA,6,5,34,0,83.3333333333333,31,155,0,22.1428571428571,20.5,2.92857142857143
"155","E.Wilson",2024,"GB",18,106,508,4,4.79245283018868,28.2222222222222,7.13580693304547,0.0673189333306177,3.77824411661398,17,12,71,1,70.5882352941177,118,579,5,32.1666666666667,99.9,5.55
"156","G.Bernard",2022,"TB",2,8,28,0,3.5,14,-6.00159577042722,-0.750199471303403,NA,2,2,-1,0,100,10,27,0,13.5,4.7,2.35
"157","G.Brightwell",2022,"NYG",9,32,151,1,4.71875,16.7777777777778,-4.81303232231242,-0.150407260072263,3.293,8,5,39,0,62.5,37,190,1,21.1111111111111,30,3.33333333333333
"158","G.Brightwell",2023,"NYG",3,9,19,0,2.11111111111111,6.33333333333333,-3.89982102555223,-0.433313447283581,NA,7,5,47,0,71.4285714285714,14,66,0,22,11.6,3.86666666666667
"159","G.Edwards",2022,"BAL",10,99,472,3,4.76767676767677,47.2,1.22433480614563,0.0123670182438953,3.48533372183372,3,1,13,0,33.3333333333333,100,485,3,48.5,65.5,6.55
"160","G.Edwards",2023,"BAL",19,211,870,13,4.12322274881517,45.7894736842105,-11.4091243628118,-0.0540716794446056,3.77278591414126,16,14,195,0,87.5,225,1065,13,56.0526315789474,196.5,10.3421052631579
"161","G.Edwards",2024,"LAC",12,108,387,4,3.58333333333333,32.25,-15.0525525307252,-0.139375486395603,3.88694494527296,5,3,6,0,60,111,393,4,32.75,66.3,5.525
"162","G.Holani",2024,"SEA",2,3,10,0,3.33333333333333,5,-0.771828435012139,-0.257276145004046,NA,1,1,-1,0,100,4,9,0,4.5,1.9,0.95
"163","G.Igwebuike",2022,"SEA",1,3,4,0,1.33333333333333,4,-1.42175994894933,-0.47391998298311,NA,1,1,3,0,100,4,7,0,7,1.7,1.7
"164","H.Haskins",2022,"TEN",7,25,93,0,3.72,13.2857142857143,-2.45266898942646,-0.0981067595770583,4.86975,12,11,57,0,91.6666666666667,36,150,0,21.4285714285714,26,3.71428571428571
"165","H.Haskins",2024,"LAC",12,35,94,2,2.68571428571429,7.83333333333333,-2.74314257508377,-0.0783755021452505,4.72060606060606,4,3,49,1,75,38,143,3,11.9166666666667,33.3,2.775
"166","I.Abanikanda",2023,"NYJ",6,22,70,0,3.18181818181818,11.6666666666667,-2.94553341485929,-0.133887882493604,NA,11,7,43,0,63.6363636363636,29,113,0,18.8333333333333,18.3,3.05
"167","I.Davis",2024,"NYJ",9,30,174,1,5.8,19.3333333333333,4.41404169931775,0.147134723310592,4.17225,12,9,75,1,75,39,249,2,27.6666666666667,45.9,5.1
"168","I.Guerendo",2024,"SF",13,84,420,4,5,32.3076923076923,4.85206715553068,0.057762704232508,3.5131277889637,16,15,152,0,93.75,99,572,4,44,96.2,7.4
"169","I.Pacheco",2022,"KC",20,207,1027,6,4.96135265700483,51.35,-1.82246122959558,-0.00880416052944726,3.66446353112617,21,19,195,0,90.4761904761905,226,1222,6,61.1,173.2,8.66
"170","I.Pacheco",2023,"KC",18,286,1248,10,4.36363636363636,69.3333333333333,-24.5243893640582,-0.0857496131610425,3.92813674140272,61,56,304,2,91.8032786885246,342,1552,12,86.2222222222222,279.2,15.5111111111111
"171","I.Pacheco",2024,"KC",10,96,347,1,3.61458333333333,34.7,-16.7108623844979,-0.174071483171853,3.96528551136364,21,15,96,0,71.4285714285714,111,443,1,44.3,65.3,6.53
"172","I.Spiller",2022,"LAC",5,18,41,0,2.27777777777778,8.2,-7.11014819156844,-0.395008232864913,NA,3,3,13,0,100,21,54,0,10.8,8.4,1.68
"173","I.Spiller",2023,"LAC",9,37,96,0,2.59459459459459,10.6666666666667,-14.3609551987611,-0.38813392429084,4.8434,6,6,34,0,100,43,130,0,14.4444444444444,19,2.11111111111111
"174","J.Brooks",2024,"CAR",3,9,22,0,2.44444444444444,7.33333333333333,-2.77792557136854,-0.308658396818727,NA,3,3,23,0,100,12,45,0,15,7.5,2.5
"175","J.Chestnut",2022,"TEN",3,9,12,0,1.33333333333333,4,-4.98684971564217,-0.55409441284913,NA,3,3,41,0,100,12,53,0,17.6666666666667,8.3,2.76666666666667
"176","J.Chestnut",2024,"TEN",7,22,102,0,4.63636363636364,14.5714285714286,-3.37659132086965,-0.153481423675893,NA,3,2,11,0,66.6666666666667,24,113,0,16.1428571428571,13.3,1.9
"177","J.Conner",2022,"ARI",13,183,782,7,4.27322404371585,60.1538461538462,-2.47490814897124,-0.0135240882457445,4.24879530381651,58,46,300,1,79.3103448275862,229,1082,8,83.2307692307692,200.2,15.4
"178","J.Conner",2023,"ARI",13,208,1040,7,5,80,13.9430584581037,0.0670339348947293,3.9011347236527,33,27,165,2,81.8181818181818,235,1205,9,92.6923076923077,201.5,15.5
"179","J.Conner",2024,"ARI",16,236,1094,8,4.63559322033898,68.375,0.071571586060216,0.000303269432458542,3.95650657840454,55,47,414,1,85.4545454545455,283,1508,9,94.25,253.8,15.8625
"180","J.Cook",2022,"BUF",18,106,559,3,5.27358490566038,31.0555555555556,2.36975018808153,0.0223561338498257,3.45920032378371,32,21,180,1,65.625,127,739,4,41.0555555555556,116.9,6.49444444444444
"181","J.Cook",2023,"BUF",19,273,1262,2,4.62271062271062,66.421052631579,-8.78795592353489,-0.032190314738223,3.8193511462036,63,52,471,4,82.5396825396825,325,1733,6,91.2105263157895,257.3,13.5421052631579
"182","J.Cook",2024,"BUF",19,260,1281,19,4.92692307692308,67.421052631579,19.531934648141,0.0751228255697732,3.53029328906228,44,38,322,2,86.3636363636364,298,1603,21,84.3684210526316,324.3,17.0684210526316
"183","J.Corbin",2023,"NYG",1,1,1,0,1,1,1.84878979931818,1.84878979931818,NA,3,3,12,0,100,4,13,0,13,4.3,4.3
"184","J.Dobbins",2022,"BAL",9,105,582,2,5.54285714285714,64.6666666666667,8.3357670709022,0.0793882578181162,3.51096955462357,13,11,85,2,84.6153846153846,116,667,4,74.1111111111111,101.7,11.3
"185","J.Dobbins",2023,"BAL",1,8,22,1,2.75,22,-1.84059488767525,-0.230074360959406,NA,3,2,15,0,66.6666666666667,10,37,1,37,11.7,11.7
"186","J.Dobbins",2024,"LAC",14,204,931,9,4.56372549019608,66.5,1.58179798299046,0.00775391168132577,4.14632788575058,39,32,153,0,82.051282051282,236,1084,9,77.4285714285714,194.4,13.8857142857143
"187","J.Ford",2022,"CLE",2,8,12,0,1.5,6,-3.42909810991129,-0.428637263738911,NA,0,0,0,0,NA,8,12,0,6,1.2,0.6
"188","J.Ford",2023,"CLE",18,213,830,4,3.89671361502347,46.1111111111111,-41.1596137027955,-0.193237623017819,5.71080279104637,67,48,334,5,71.6417910447761,261,1164,9,64.6666666666667,220.4,12.2444444444444
"189","J.Ford",2024,"CLE",14,104,565,3,5.43269230769231,40.3571428571429,5.03220676237048,0.0483866034843315,4.14453539025503,43,37,225,0,86.046511627907,141,790,3,56.4285714285714,134,9.57142857142857
"190","J.Funk",2023,"IND",1,2,10,0,5,10,-0.883889150689356,-0.441944575344678,NA,1,1,12,0,100,3,22,0,22,3.2,3.2
"191","J.Gibbs",2023,"DET",18,211,1089,13,5.16113744075829,60.5,-5.90829683736763,-0.0280014068121689,4.25075447004767,85,63,410,1,74.1176470588235,274,1499,14,83.2777777777778,292.9,16.2722222222222
"192","J.Gibbs",2024,"DET",18,264,1517,18,5.74621212121212,84.2777777777778,40.4108765275634,0.153071501998346,3.75983947393277,74,58,567,3,78.3783783783784,322,2084,21,115.777777777778,390.4,21.6888888888889
"193","J.Hasty",2022,"JAX",15,50,230,2,4.6,15.3333333333333,-5.68694911466446,-0.113738982293289,5.58597943722944,28,21,133,1,75,71,363,3,24.2,75.3,5.02
"194","J.Hasty",2023,"JAX",1,0,0,0,NA,0,0,NA,NA,2,0,0,0,0,0,0,0,0,0,0
"195","J.Hasty",2024,"NE",9,20,69,0,3.45,7.66666666666667,-1.01269370431382,-0.050634685215691,NA,12,10,59,1,83.3333333333333,30,128,1,14.2222222222222,28.8,3.2
"196","J.Hill",2022,"BAL",14,49,262,0,5.3469387755102,18.7142857142857,-3.18598145133001,-0.0650200296189797,NA,14,14,68,0,100,63,330,0,23.5714285714286,45,3.21428571428571
"197","J.Hill",2023,"BAL",18,100,456,3,4.56,25.3333333333333,-0.645936148975552,-0.00645936148975552,5.21302552376485,48,34,251,1,70.8333333333333,134,707,4,39.2777777777778,126.7,7.03888888888889
"198","J.Hill",2024,"BAL",17,59,290,1,4.91525423728814,17.0588235294118,0.813173024565913,0.0137825936367104,NA,57,48,403,4,84.2105263157895,107,693,5,40.7647058823529,147.3,8.66470588235294
"199","J.Howard",2022,"NO",1,1,1,0,1,1,-0.476197482086718,-0.476197482086718,NA,0,0,0,0,NA,1,1,0,1,0.1,0.1
"200","J.Jackson",2022,"DET",12,42,170,1,4.04761904761905,14.1666666666667,-9.89926428315812,-0.235696768646622,NA,19,12,101,1,63.1578947368421,54,271,2,22.5833333333333,51.1,4.25833333333333
"201","J.Jacobs",2022,"LV",17,340,1653,12,4.86176470588235,97.2352941176471,-0.734085212900101,-0.00215907415558853,3.60186204758529,64,53,400,0,82.8125,393,2053,12,120.764705882353,328.3,19.3117647058824
"202","J.Jacobs",2023,"LV",13,233,805,6,3.4549356223176,61.9230769230769,-44.3192915947308,-0.190211551908716,4.30310682707709,54,37,296,0,68.5185185185185,270,1101,6,84.6923076923077,181.1,13.9307692307692
"203","J.Jacobs",2024,"GB",18,319,1410,16,4.42006269592476,78.3333333333333,-18.3426827516254,-0.057500572889108,3.76453743276337,46,39,382,1,84.7826086956522,358,1792,17,99.5555555555556,314.2,17.4555555555556
"204","J.Jefferson",2024,"DET",2,6,22,0,3.66666666666667,11,-0.785035908455029,-0.130839318075838,NA,1,1,10,0,100,7,32,0,16,4.2,2.1
"205","J.Kelley",2022,"LAC",13,76,307,2,4.03947368421053,23.6153846153846,0.852150318911299,0.0112125041962013,4.07914965986394,26,15,109,0,57.6923076923077,91,416,2,32,68.6,5.27692307692308
"206","J.Kelley",2023,"LAC",17,107,405,2,3.78504672897196,23.8235294117647,-26.1540332020189,-0.244430216841299,6.24838644688645,12,8,32,0,66.6666666666667,115,437,2,25.7058823529412,61.7,3.62941176470588
"207","J.Kelley",2024,"TEN",1,1,2,0,2,2,-0.386650822241791,-0.386650822241791,NA,0,0,0,0,NA,1,2,0,2,0.2,0.2
"208","J.Kibodi",2024,"CLE",1,5,24,0,4.8,24,-0.737081334460527,-0.147416266892105,NA,3,1,15,0,33.3333333333333,6,39,0,39,4.9,4.9
"209","J.Mason",2022,"SF",9,45,270,1,6,30,2.81292072922224,0.062509349538272,3.66553571428571,0,0,0,0,NA,45,270,1,30,33,3.66666666666667
"210","J.Mason",2023,"SF",9,40,206,3,5.15,22.8888888888889,5.64875688121538,0.141218922030384,2.6331884057971,4,3,31,0,75,43,237,3,26.3333333333333,44.7,4.96666666666667
"211","J.Mason",2024,"SF",12,153,789,3,5.15686274509804,65.75,-5.44239982114777,-0.0355712406610965,3.52948377951116,14,11,91,0,78.5714285714286,164,880,3,73.3333333333333,115,9.58333333333333
"212","J.McClellan",2024,"ATL",2,13,32,0,2.46153846153846,16,-7.10460604215041,-0.546508157088493,NA,0,0,0,0,NA,13,32,0,16,3.2,1.6
"213","J.McKinnon",2022,"KC",20,91,351,1,3.85714285714286,17.55,-12.6120392371959,-0.138593837771383,4.82530769230769,78,61,544,9,78.2051282051282,152,895,10,44.75,210.5,10.525
"214","J.McKinnon",2023,"KC",13,21,60,1,2.85714285714286,4.61538461538461,-0.0179227527287371,-0.000853464415654148,NA,34,27,207,4,79.4117647058823,48,267,5,20.5384615384615,87.86,6.75846153846154
"215","J.McKissic",2022,"WAS",8,22,95,0,4.31818181818182,11.875,-3.98311869439203,-0.181050849745092,NA,40,27,173,0,67.5,49,268,0,33.5,55.8,6.975
"216","J.McLaughlin",2023,"DEN",17,76,410,1,5.39473684210526,24.1176470588235,5.87916513410164,0.0773574359750216,NA,36,31,160,2,86.1111111111111,107,570,3,33.5294117647059,106,6.23529411764706
"217","J.McLaughlin",2024,"DEN",17,115,494,1,4.29565217391304,29.0588235294118,-2.71405068910099,-0.0236004407747912,4.87838793553467,28,25,76,2,89.2857142857143,140,570,3,33.5294117647059,98,5.76470588235294
"218","J.McNichols",2024,"WAS",16,60,270,5,4.5,16.875,7.14710472166117,0.119118412027686,NA,12,9,27,0,75,69,297,5,18.5625,70.7,4.41875
"219","J.Mims",2023,"NO",1,0,0,0,NA,0,0,NA,NA,2,0,0,0,0,0,0,0,0,0,0
"220","J.Mims",2024,"NO",7,20,70,0,3.5,10,-3.17677546018967,-0.158838773009484,NA,18,12,71,0,66.6666666666667,32,141,0,20.1428571428571,26.1,3.72857142857143
"221","J.Mixon",2022,"CIN",17,249,977,8,3.92369477911647,57.4705882352941,-10.7249958900275,-0.0430722726507129,4.65189672186895,85,68,491,2,80,317,1468,10,86.3529411764706,274.8,16.1647058823529
"222","J.Mixon",2023,"CIN",17,257,1034,9,4.02334630350195,60.8235294117647,-18.0473119154472,-0.0702230035620513,3.81669409156627,64,52,376,3,81.25,309,1410,12,82.9411764705882,267,15.7058823529412
"223","J.Mixon",2024,"HOU",16,288,1210,13,4.20138888888889,75.625,-15.8304424775801,-0.0549668141582643,4.93973168608254,57,39,334,1,68.421052631579,327,1544,14,96.5,275.4,17.2125
"224","J.Patterson",2022,"WAS",1,17,78,0,4.58823529411765,78,-1.09624081887108,-0.0644847540512401,3.32269230769231,1,0,0,0,0,17,78,0,78,7.8,7.8
"225","J.Robinson",2022,"JAX",7,81,340,3,4.19753086419753,48.5714285714286,-7.96942178628524,-0.0983879232874721,3.91384018097643,11,9,46,1,81.8181818181818,90,386,4,55.1428571428571,71.6,10.2285714285714
"226","J.Robinson",2022,"NYJ",4,29,85,0,2.93103448275862,21.25,-6.71914732726873,-0.23169473542306,4.17145833333333,3,2,5,1,66.6666666666667,31,90,1,22.5,17,4.25
"227","J.Robinson",2023,"GB",1,1,2,0,2,2,-0.481721363612451,-0.481721363612451,NA,1,1,-2,0,100,2,0,0,0,1,1
"228","J.Taylor",2022,"IND",11,192,861,4,4.484375,78.2727272727273,-28.6548071599877,-0.149243787291603,3.53971038501031,40,28,143,0,70,220,1004,4,91.2727272727273,146.4,13.3090909090909
"229","J.Taylor",2022,"NE",1,10,9,0,0.9,9,-5.49107612241642,-0.549107612241642,12.8155555555556,1,1,8,0,100,11,17,0,17,2.7,2.7
"230","J.Taylor",2023,"IND",10,169,741,7,4.38461538461539,74.1,-10.159002013305,-0.0601124379485502,3.60799256211231,23,19,153,1,82.6086956521739,188,894,8,89.4,156.4,15.64
"231","J.Taylor",2024,"HOU",3,10,44,0,4.4,14.6666666666667,-0.0250057432567701,-0.00250057432567701,NA,3,2,0,0,66.6666666666667,12,44,0,14.6666666666667,6.4,2.13333333333333
"232","J.Taylor",2024,"IND",14,303,1431,11,4.72277227722772,102.214285714286,-21.015317083567,-0.0693574821239836,3.66241023277839,31,18,136,1,58.0645161290323,321,1567,12,111.928571428571,246.7,17.6214285714286
"233","J.Ward",2022,"TEN",2,5,25,0,5,12.5,-0.873255413025618,-0.174651082605124,NA,3,2,7,0,66.6666666666667,7,32,0,16,5.2,2.6
"234","J.Ward",2023,"TEN",1,3,11,0,3.66666666666667,11,-1.81841936230194,-0.60613978743398,NA,0,0,0,0,NA,3,11,0,11,1.1,1.1
"235","J.Ward",2024,"PIT",2,5,22,0,4.4,11,0.204633340588771,0.0409266681177542,NA,0,0,0,0,NA,5,22,0,11,2.2,1.1
"236","J.Warren",2022,"PIT",16,77,379,1,4.92207792207792,23.6875,8.39019118724006,0.108963521912209,4.23638157894737,33,28,214,0,84.8484848484848,105,593,1,37.0625,93.3,5.83125
"237","J.Warren",2023,"PIT",18,157,822,4,5.23566878980892,45.6666666666667,-4.36250913621306,-0.0277866823962615,3.69166439666416,76,63,386,0,82.8947368421053,220,1208,4,67.1111111111111,203.8,11.3222222222222
"238","J.Warren",2024,"PIT",16,122,517,1,4.23770491803279,32.3125,-14.1292548368015,-0.115813564236078,3.70919163821312,52,42,329,0,80.7692307692308,164,846,1,52.875,130.6,8.1625
"239","J.Wilkins",2022,"IND",4,13,58,0,4.46153846153846,14.5,-1.31315452896524,-0.10101188684348,NA,8,6,29,0,75,19,87,0,21.75,14.7,3.675
"240","J.Williams",2022,"DEN",4,47,204,0,4.34042553191489,51,-6.31136679562042,-0.134284399906817,4.39728795840175,22,16,76,0,72.7272727272727,63,280,0,70,42,10.5
"241","J.Williams",2022,"DET",17,262,1066,17,4.06870229007634,62.7058823529412,-26.0265208153877,-0.0993378657075868,3.75636923222107,16,12,73,0,75,274,1139,17,67,225.9,13.2882352941176
"242","J.Williams",2022,"WAS",7,37,152,0,4.10810810810811,21.7142857142857,-7.74118973047007,-0.209221344066759,6.3628125,10,7,40,0,70,44,192,0,27.4285714285714,26.2,3.74285714285714
"243","J.Williams",2023,"DEN",16,217,774,3,3.5668202764977,48.375,-37.9041038689783,-0.174673289718794,4.65529435878217,58,47,228,2,81.0344827586207,264,1002,5,62.625,179.2,11.2
"244","J.Williams",2023,"NO",13,106,306,1,2.88679245283019,23.5384615384615,-26.2487587626612,-0.247629799647748,4.84809918505267,20,18,62,0,90,124,368,1,28.3076923076923,60.8,4.67692307692308
"245","J.Williams",2023,"WAS",1,1,-2,0,-2,-2,-0.994746600277722,-0.994746600277722,NA,1,0,0,0,0,1,-2,0,-2,-0.2,-0.2
"246","J.Williams",2024,"DEN",18,146,542,4,3.71232876712329,30.1111111111111,-24.8372960578792,-0.170118466149857,4.54250201247911,72,54,360,0,75,200,902,4,50.1111111111111,164.2,9.12222222222223
"247","J.Williams",2024,"NO",13,48,164,1,3.41666666666667,12.6153846153846,-9.67190718204231,-0.201498066292548,4.41157894736842,11,9,57,0,81.8181818181818,57,221,1,17,37.1,2.85384615384615
"248","J.Wilson",2022,"MIA",9,94,415,4,4.41489361702128,46.1111111111111,8.47127258200447,0.090119921085154,4.86944658119658,28,13,107,1,46.4285714285714,107,522,5,58,95.2,10.5777777777778
"249","J.Wilson",2022,"SF",8,92,468,2,5.08695652173913,58.5,-3.80092950290418,-0.0413144511185237,3.3069059041184,13,10,91,0,76.9230769230769,102,559,2,69.875,73.9,9.2375
"250","J.Wilson",2023,"MIA",10,41,188,0,4.58536585365854,18.8,-0.923272557498422,-0.0225188428658152,3.59571428571429,19,15,91,0,78.9473684210526,56,279,0,27.9,42.9,4.29
"251","J.Wilson",2024,"MIA",7,16,57,0,3.5625,8.14285714285714,-4.62643494537559,-0.289152184085975,NA,3,3,19,0,100,19,76,0,10.8571428571429,10.6,1.51428571428571
"252","J.Wright",2024,"MIA",13,68,249,0,3.66176470588235,19.1538461538462,-20.3124552579829,-0.298712577323279,3.48302325581395,6,3,8,0,50,71,257,0,19.7692307692308,26.7,2.05384615384615
"253","K.Drake",2022,"BAL",12,109,482,4,4.42201834862385,40.1666666666667,-12.4995593839561,-0.114674856733542,9.22860378943536,26,17,89,1,65.3846153846154,126,571,5,47.5833333333333,104.1,8.675
"254","K.Drake",2023,"BAL",1,1,0,0,0,0,-0.520651209750213,-0.520651209750213,NA,3,2,31,0,66.6666666666667,3,31,0,31,3.1,3.1
"255","K.Drake",2023,"GB",1,1,0,0,0,0,-0.38270552479662,-0.38270552479662,NA,0,0,0,0,NA,1,0,0,0,0,0
"256","K.Gainwell",2022,"PHI",20,86,421,5,4.8953488372093,21.05,21.3851745778083,0.248664820672189,3.12208333333333,38,30,224,0,78.9473684210526,116,645,5,32.25,124.5,6.225
"257","K.Gainwell",2023,"PHI",17,88,367,2,4.17045454545455,21.5882352941176,-15.1692800327801,-0.172378182190683,3.64009259259259,39,32,193,0,82.051282051282,120,560,2,32.9411764705882,100.68,5.92235294117647
"258","K.Gainwell",2024,"PHI",20,88,332,1,3.77272727272727,16.6,-13.6306470808123,-0.154893716827412,7.91598214285714,25,19,142,0,76,107,474,1,23.7,72.4,3.62
"259","K.Harris",2022,"NE",5,18,52,1,2.88888888888889,10.4,-1.94094609777676,-0.107830338765376,NA,0,0,0,0,NA,18,52,1,10.4,11.2,2.24
"260","K.Harris",2023,"NE",4,16,65,1,4.0625,16.25,-2.28036905411864,-0.142523065882415,NA,3,3,58,0,100,19,123,1,30.75,21.3,5.325
"261","K.Herbert",2022,"CHI",13,129,731,4,5.66666666666667,56.2307692307692,1.17196801237346,0.00908502335173223,3.44283279038115,12,9,57,1,75,138,788,5,60.6153846153846,117.8,9.06153846153846
"262","K.Herbert",2023,"CHI",12,132,611,2,4.62878787878788,50.9166666666667,-2.62244654025513,-0.019867019244357,3.96883842622136,31,20,134,1,64.5161290322581,152,745,3,62.0833333333333,112.5,9.375
"263","K.Herbert",2024,"CHI",3,8,16,1,2,5.33333333333333,3.46308733976912,0.43288591747114,NA,2,2,4,0,100,10,20,1,6.66666666666667,10,3.33333333333333
"264","K.Herbert",2024,"CIN",5,28,114,0,4.07142857142857,22.8,-1.40933737298851,-0.0503334776067324,3.43101449275362,9,8,21,0,88.8888888888889,36,135,0,27,21.5,4.3
"265","K.Hill",2022,"GB",1,1,7,0,7,7,0.546071149292402,0.546071149292402,NA,0,0,0,0,NA,1,7,0,7,0.7,0.7
"266","K.Hunt",2022,"CLE",17,123,468,3,3.80487804878049,27.5294117647059,-11.557620754056,-0.0939643963744392,3.92257720647565,44,35,210,1,79.5454545454545,158,678,4,39.8823529411765,126.8,7.45882352941177
"267","K.Hunt",2023,"CLE",16,143,437,10,3.05594405594406,27.3125,-5.76359297252063,-0.0403048459616827,4.361754955195,27,20,93,1,74.0740740740741,163,530,11,33.125,139,8.6875
"268","K.Hunt",2024,"KC",16,228,845,9,3.70614035087719,52.8125,2.75300599353561,0.0120745876909456,3.80434005748003,35,26,189,0,74.2857142857143,254,1034,9,64.625,183.4,11.4625
"269","K.Ingram",2022,"ARI",10,27,60,1,2.22222222222222,6,-9.23134566671797,-0.341901691359925,NA,5,4,21,0,80,31,81,1,8.1,18.1,1.81
"270","K.Ingram",2023,"ARI",7,35,74,0,2.11428571428571,10.5714285714286,-11.3167110374243,-0.323334601069265,4.25925,4,4,26,0,100,39,100,0,14.2857142857143,14,2
"271","K.McIntosh",2024,"SEA",7,31,172,0,5.54838709677419,24.5714285714286,1.48807978018885,0.0480025735544792,NA,4,3,22,0,75,34,194,0,27.7142857142857,22.4,3.2
"272","K.Miller",2023,"NO",7,41,156,1,3.80487804878049,22.2857142857143,-3.09782426408492,-0.0755566893679249,4.57088670862643,11,10,117,0,90.9090909090909,51,273,1,39,43.3,6.18571428571429
"273","K.Miller",2024,"NO",6,39,148,1,3.7948717948718,24.6666666666667,-5.37066567892907,-0.137709376382797,7.24125,8,5,33,0,62.5,44,181,1,30.1666666666667,29.1,4.85
"274","K.Mitchell",2023,"BAL",7,47,396,2,8.42553191489362,56.5714285714286,17.4030145683791,0.370276905710195,NA,11,9,93,0,81.8181818181818,56,489,2,69.8571428571429,69.9,9.98571428571429
"275","K.Mitchell",2024,"BAL",2,15,30,0,2,15,-5.21328950952739,-0.347552633968492,7.1515,1,1,28,0,100,16,58,0,29,6.8,3.4
"276","K.Nwangwu",2022,"MIN",3,9,14,0,1.55555555555556,4.66666666666667,-4.24055263578984,-0.47117251508776,NA,2,2,21,0,100,11,35,0,11.6666666666667,11.5,3.83333333333333
"277","K.Nwangwu",2023,"MIN",3,5,13,0,2.6,4.33333333333333,-0.822951464913785,-0.164590292982757,NA,0,0,0,0,NA,5,13,0,4.33333333333333,1.3,0.433333333333333
"278","K.Nwangwu",2024,"NYJ",1,0,0,0,NA,0,0,NA,NA,0,0,0,0,NA,0,0,0,0,6,6
"279","K.Vaughn",2022,"TB",5,17,53,0,3.11764705882353,10.6,-2.99027192313224,-0.175898348419544,NA,4,3,19,0,75,20,72,0,14.4,10.2,2.04
"280","K.Vaughn",2023,"TB",5,24,42,0,1.75,8.4,-11.1368328029639,-0.464034700123496,NA,5,2,2,0,40,26,44,0,8.8,6.4,1.28
"281","K.Vaughn",2024,"SF",1,2,4,0,2,4,-0.63253441057168,-0.31626720528584,NA,0,0,0,0,NA,2,4,0,4,0.4,0.4
"282","K.Vidal",2024,"LAC",9,43,155,0,3.6046511627907,17.2222222222222,-8.4080203021891,-0.195535355864863,NA,9,5,62,1,55.5555555555556,48,217,1,24.1111111111111,32.7,3.63333333333333
"283","K.Walker",2022,"SEA",16,243,1113,10,4.58024691358025,69.5625,-13.0574996133708,-0.0537345663101681,5.26276767772428,36,28,168,0,77.7777777777778,271,1281,10,80.0625,216.1,13.50625
"284","K.Walker",2023,"SEA",15,219,905,8,4.1324200913242,60.3333333333333,-9.32750174283865,-0.0425913321590806,4.71530839793922,37,29,259,1,78.3783783783784,248,1164,9,77.6,199.4,13.2933333333333
"285","K.Walker",2024,"SEA",11,153,573,7,3.74509803921569,52.0909090909091,-12.1427636038239,-0.0793644679988493,4.97997253862295,53,46,299,1,86.7924528301887,199,872,8,79.2727272727273,181.2,16.4727272727273
"286","K.Williams",2022,"LA",8,35,139,0,3.97142857142857,17.375,-4.25223541839744,-0.121492440525641,4.582,12,9,76,0,75,44,215,0,26.875,30.5,3.8125
"287","K.Williams",2023,"LA",13,241,1205,12,5,92.6923076923077,21.5325162802015,0.0893465405817489,3.40252965394879,49,33,215,3,67.3469387755102,274,1420,15,109.230769230769,263,20.2307692307692
"288","K.Williams",2024,"LA",18,351,1481,14,4.21937321937322,82.2777777777778,-31.6678772202382,-0.0902218724223311,3.9061653241823,45,38,197,3,84.4444444444444,389,1678,17,93.2222222222222,299.8,16.6555555555556
"289","L.Fournette",2022,"TB",17,194,679,3,3.5,39.9411764705882,-39.1293580982513,-0.201697722155934,3.91250394447645,84,74,529,3,88.0952380952381,268,1208,6,71.0588235294118,228.8,13.4588235294118
"290","L.Fournette",2023,"BUF",2,12,40,0,3.33333333333333,20,-1.12259652133798,-0.0935497101114985,NA,0,0,0,0,NA,12,40,0,20,4,2
"291","L.Murray",2022,"DEN",12,160,703,5,4.39375,58.5833333333333,-8.79914383373192,-0.0549946489608245,3.46846424552938,34,26,124,0,76.4705882352941,186,827,5,68.9166666666667,140.7,11.725
"292","L.Murray",2022,"NO",1,11,57,1,5.18181818181818,57,2.87068020517472,0.260970927743156,3.21526315789474,1,1,8,0,100,12,65,1,65,13.5,13.5
"293","L.Murray",2023,"BUF",17,79,300,4,3.79746835443038,17.6470588235294,-2.56229843876885,-0.0324341574527702,3.33166666666667,28,22,159,0,78.5714285714286,101,459,4,27,91.9,5.40588235294118
"294","L.Perine",2023,"KC",2,22,77,0,3.5,38.5,-2.3794992521381,-0.108159056915368,4.34462686567164,5,3,33,0,60,25,110,0,55,14,7
"295","L.Rountree",2022,"LAC",2,13,19,0,1.46153846153846,9.5,-7.25853434327291,-0.558348795636378,10.5026666666667,2,2,14,0,100,15,33,0,16.5,5.3,2.65
"296","M.Boone",2022,"DEN",8,24,102,0,4.25,12.75,-3.69021995814889,-0.15375916492287,NA,15,9,96,0,60,33,198,0,24.75,28.8,3.6
"297","M.Boone",2023,"HOU",7,5,23,0,4.6,3.28571428571429,-1.99815420841333,-0.399630841682665,NA,9,7,40,0,77.7777777777778,12,63,0,9,13.3,1.9
"298","M.Boone",2024,"CAR",5,13,51,0,3.92307692307692,10.2,-0.974716876691673,-0.0749782212839748,NA,3,1,-2,0,33.3333333333333,14,49,0,9.8,5.9,1.18
"299","M.Breida",2022,"NYG",19,61,251,2,4.11475409836066,13.2105263157895,2.70195065237931,0.0442942729898248,NA,26,21,137,0,80.7692307692308,82,388,2,20.421052631579,71.8,3.77894736842105
"300","M.Breida",2023,"NYG",15,55,151,1,2.74545454545455,10.0666666666667,-13.7199769179547,-0.249454125780995,4.775,21,17,88,0,80.952380952381,72,239,1,15.9333333333333,46.9,3.12666666666667
"301","M.Brown",2022,"LA",7,18,81,1,4.5,11.5714285714286,-0.493505536956112,-0.0274169742753396,NA,6,5,37,0,83.3333333333333,23,118,1,16.8571428571429,22.8,3.25714285714286
"302","M.Carter",2022,"NYJ",16,114,402,3,3.52631578947368,25.125,-21.690917342175,-0.190271204755921,5.13600117136342,54,41,288,0,75.9259259259259,155,690,3,43.125,126,7.875
"303","M.Carter",2023,"ARI",6,22,149,0,6.77272727272727,24.8333333333333,3.62539649329847,0.164790749695385,NA,11,9,33,1,81.8181818181818,31,182,1,30.3333333333333,33.2,5.53333333333333
"304","M.Carter",2023,"NYJ",9,8,38,0,4.75,4.22222222222222,-0.568969595998379,-0.0711211994997973,NA,20,15,68,0,75,23,106,0,11.7777777777778,25.6,2.84444444444444
"305","M.Carter",2024,"ARI",3,35,131,1,3.74285714285714,43.6666666666667,-0.478533695780356,-0.0136723913080102,4.64388372093023,11,11,57,0,100,46,188,1,62.6666666666667,35.8,11.9333333333333
"306","M.Davis",2022,"BAL",5,8,18,0,2.25,3.6,-2.99710205767769,-0.374637757209712,NA,2,2,4,0,100,10,22,0,4.4,4.2,0.84
"307","M.Davis",2022,"DAL",6,38,161,1,4.23684210526316,26.8333333333333,-3.50220239717908,-0.0921632209783967,3.97692307692308,7,6,63,0,85.7142857142857,44,224,1,37.3333333333333,34.4,5.73333333333333
"308","M.Gaskin",2022,"MIA",2,10,26,0,2.6,13,-4.99477203493007,-0.499477203493007,NA,6,4,28,0,66.6666666666667,14,54,0,27,9.4,4.7
"309","M.Gaskin",2024,"MIN",2,3,-1,0,-0.333333333333333,-0.5,-2.23702167416923,-0.745673891389742,NA,1,1,11,0,100,4,10,0,5,2,1
"310","M.Gordon",2022,"DEN",10,90,318,2,3.53333333333333,31.8,-29.6152288955781,-0.329058098839757,4.65436579786617,32,25,223,0,78.125,115,541,2,54.1,87.1,8.71
"311","M.Gordon",2023,"BAL",4,26,81,1,3.11538461538462,20.25,-7.11024274167721,-0.273470874679893,3.6475,3,3,46,0,100,29,127,1,31.75,19.7,4.925
"312","M.Ingram",2022,"NO",10,62,233,1,3.75806451612903,23.3,-11.0297620060737,-0.177899387194737,4.12188505747126,18,16,68,0,88.8888888888889,78,301,1,30.1,50.1,5.01
"313","M.Lloyd",2024,"GB",1,6,15,0,2.5,15,-1.80517367087305,-0.300862278478841,NA,1,1,3,0,100,7,18,0,18,2.8,2.8
"314","M.Mack",2022,"DEN",5,16,84,1,5.25,16.8,-0.891764602274634,-0.0557352876421646,NA,10,8,99,1,80,24,183,2,36.6,38.3,7.66
"315","M.Sanders",2022,"PHI",20,294,1417,13,4.81972789115646,70.85,13.0477396512288,0.0443800668409142,3.91073138027268,28,21,81,0,75,315,1498,13,74.9,244.8,12.24
"316","M.Sanders",2023,"CAR",16,129,432,1,3.34883720930233,27,-30.5452764339861,-0.236785088635552,5.10857492779981,41,27,154,0,65.8536585365854,156,586,1,36.625,87.6,5.475
"317","M.Sanders",2024,"CAR",11,55,205,2,3.72727272727273,18.6363636363636,-8.65984749678165,-0.157451772668757,3.91954545454545,30,24,148,1,80,79,353,3,32.0909090909091,77.3,7.02727272727273
"318","N.Chubb",2022,"CLE",17,302,1525,12,5.04966887417219,89.7058823529412,13.2250271103403,0.0437914804978156,4.33150065818716,37,27,239,1,72.972972972973,329,1764,13,103.764705882353,281.4,16.5529411764706
"319","N.Chubb",2023,"CLE",2,28,170,0,6.07142857142857,85,4.1136986236088,0.146917807986028,3.12809551886792,4,4,21,0,100,32,191,0,95.5,23.1,11.55
"320","N.Chubb",2024,"CLE",8,102,332,3,3.25490196078431,41.5,-20.5745782894754,-0.201711551857602,4.86805389175326,11,5,31,1,45.4545454545455,107,363,4,45.375,63.3,7.9125
"321","N.Harris",2022,"PIT",17,272,1034,7,3.80147058823529,60.8235294117647,-28.6515734960089,-0.105336667264738,4.57949412241246,53,41,229,3,77.3584905660377,313,1263,10,74.2941176470588,223.46,13.1447058823529
"322","N.Harris",2023,"PIT",18,267,1072,8,4.01498127340824,59.5555555555556,-27.6679054013066,-0.103625113862572,4.19220466790419,41,31,185,0,75.609756097561,298,1257,8,69.8333333333333,202.7,11.2611111111111
"323","N.Harris",2024,"PIT",18,269,1060,6,3.94052044609665,58.8888888888889,-18.3108754303539,-0.068070168886074,4.73199895143491,51,39,324,0,76.4705882352941,308,1384,6,76.8888888888889,213.4,11.8555555555556
"324","N.Hines",2022,"BUF",11,6,-3,0,-0.5,-0.272727272727273,-4.88012080895714,-0.813353468159524,NA,12,7,64,1,58.3333333333333,13,61,1,5.54545454545455,31.1,2.82727272727273
"325","N.Hines",2022,"IND",7,18,36,1,2,5.14285714285714,-8.41797400742191,-0.467665222634551,NA,28,25,188,0,89.2857142857143,43,224,1,32,53.4,7.62857142857143
"326","P.Lindsay",2022,"IND",3,15,49,0,3.26666666666667,16.3333333333333,-2.81885216041701,-0.187923477361134,3.9515,8,6,19,0,75,21,68,0,22.6666666666667,14.8,4.93333333333333
"327","P.Strong",2022,"NE",4,10,100,1,10,25,5.73718278732849,0.573718278732849,NA,7,7,42,0,100,17,142,1,35.5,27.2,6.8
"328","P.Strong",2023,"CLE",13,63,291,1,4.61904761904762,22.3846153846154,-9.93003623798722,-0.157619622825194,4.0442626641651,8,5,47,0,62.5,68,338,1,26,42.8,3.29230769230769
"329","P.Strong",2024,"CLE",11,26,108,0,4.15384615384615,9.81818181818182,-1.51613372412976,-0.0583128355434523,NA,22,14,104,0,63.6363636363636,40,212,0,19.2727272727273,35.2,3.2
"330","P.Taylor",2022,"GB",4,10,31,0,3.1,7.75,-1.89306988584576,-0.189306988584576,NA,1,1,17,0,100,11,48,0,12,5.8,1.45
"331","P.Taylor",2023,"GB",11,35,147,0,4.2,13.3636363636364,-5.15183808614986,-0.147195373889996,NA,17,11,49,0,64.7058823529412,46,196,0,17.8181818181818,30.6,2.78181818181818
"332","P.Taylor",2024,"SF",5,39,183,1,4.69230769230769,36.6,2.13986832962837,0.0548684187084198,2.91522935779816,11,3,25,0,27.2727272727273,42,208,1,41.6,29.8,5.96
"333","R.Ali",2024,"BAL",4,10,31,0,3.1,7.75,-1.15656615432817,-0.115656615432817,NA,2,0,0,0,0,10,31,0,7.75,3.1,0.775
"334","R.Blackshear",2022,"CAR",10,23,77,3,3.34782608695652,7.7,1.26981854616315,0.0552095020070935,NA,12,10,93,0,83.3333333333333,33,170,3,17,45,4.5
"335","R.Blackshear",2023,"CAR",8,14,46,0,3.28571428571429,5.75,-4.49289812838458,-0.320921294884613,NA,7,6,45,0,85.7142857142857,20,91,0,11.375,17.1,2.1375
"336","R.Blackshear",2024,"CAR",3,15,80,0,5.33333333333333,26.6666666666667,-0.66176023427397,-0.044117348951598,NA,0,0,0,0,NA,15,80,0,26.6666666666667,8,2.66666666666667
"337","R.Bonnafon",2022,"WAS",1,3,8,0,2.66666666666667,8,-1.07405631127767,-0.358018770425891,NA,0,0,0,0,NA,3,8,0,8,0.8,0.8
"338","R.Burkhead",2022,"HOU",15,26,80,0,3.07692307692308,5.33333333333333,-6.80974265857367,-0.26191317917591,4.5375,51,37,204,1,72.5490196078431,63,284,1,18.9333333333333,71.4,4.76
"339","R.Davis",2024,"BUF",19,120,478,4,3.98333333333333,25.1578947368421,-3.74059050698821,-0.031171587558235,3.78385670648557,19,17,189,3,89.4736842105263,137,667,7,35.1052631578947,125.7,6.61578947368421
"340","R.Dowdle",2023,"DAL",17,91,372,2,4.08791208791209,21.8823529411765,-5.40310363632205,-0.0593747652343082,3.28114749587232,25,19,158,2,76,110,530,4,31.1764705882353,98,5.76470588235294
"341","R.Dowdle",2024,"DAL",16,235,1079,2,4.59148936170213,67.4375,-10.528278699356,-0.0448011859547064,3.73377095190937,49,39,249,3,79.5918367346939,274,1328,5,83,197.8,12.3625
"342","R.Freeman",2022,"HOU",4,41,117,0,2.85365853658537,29.25,-15.4241196003859,-0.376198039033802,5.53101715686274,8,6,33,0,75,47,150,0,37.5,19,4.75
"343","R.Freeman",2023,"LA",9,77,319,2,4.14285714285714,35.4444444444444,-6.53368074275849,-0.0848529966592012,3.73992483080561,2,1,13,0,50,78,332,2,36.8888888888889,46.2,5.13333333333333
"344","R.Johnson",2023,"CHI",15,81,352,2,4.34567901234568,23.4666666666667,-6.61616354286162,-0.0816810313933533,4.19114285714286,40,34,209,0,85,115,561,2,37.4,102.1,6.80666666666667
"345","R.Johnson",2024,"CHI",12,55,150,6,2.72727272727273,12.5,-4.45237365386586,-0.0809522482521065,3.79261212121212,20,16,104,0,80,71,254,6,21.1666666666667,77.4,6.45
"346","R.Jones",2022,"KC",6,18,70,1,3.88888888888889,11.6666666666667,0.524325935053639,0.0291292186140911,3.20888888888889,1,1,22,0,100,19,92,1,15.3333333333333,16.2,2.7
"347","R.Mostert",2022,"MIA",16,181,891,3,4.92265193370166,55.6875,-0.987838224333245,-0.00545766974769749,3.85062292735744,42,31,202,2,73.8095238095238,212,1093,5,68.3125,168.3,10.51875
"348","R.Mostert",2023,"MIA",16,217,1045,18,4.81566820276498,65.3125,16.8129710173525,0.0774791291122237,4.43949514399288,34,26,172,3,76.4705882352941,243,1217,21,76.0625,271.7,16.98125
"349","R.Mostert",2024,"MIA",12,85,278,2,3.27058823529412,23.1666666666667,-30.1994221058003,-0.355287318891768,4.34367857142857,23,19,161,0,82.6086956521739,104,439,2,36.5833333333333,70.9,5.90833333333333
"350","R.Penny",2022,"SEA",5,57,346,2,6.07017543859649,69.2,13.1444890796556,0.230605071572905,3.19189123018262,5,4,16,0,80,61,362,2,72.4,52.2,10.44
"351","R.Penny",2023,"PHI",3,11,33,0,3,11,-3.29437441227492,-0.299488582934084,NA,1,1,5,0,100,12,38,0,12.6666666666667,4.8,1.6
"352","R.Rivers",2022,"LA",2,9,21,0,2.33333333333333,10.5,-3.69308078102767,-0.410342309003075,NA,5,5,29,0,100,14,50,0,25,10,5
"353","R.Rivers",2023,"LA",8,35,138,0,3.94285714285714,17.25,-5.21620577863743,-0.149034450818212,3.39480769230769,8,8,57,0,100,43,195,0,24.375,27.5,3.4375
"354","R.Rivers",2024,"LA",6,25,107,0,4.28,17.8333333333333,0.569221278157784,0.0227688511263113,3.44583333333333,6,5,34,0,83.3333333333333,30,141,0,23.5,19.1,3.18333333333333
"355","R.Stevenson",2022,"NE",17,210,1040,5,4.95238095238095,61.1764705882353,-9.57135560322714,-0.0455778838248912,3.87944614700063,88,69,421,1,78.4090909090909,279,1461,6,85.9411764705882,249.1,14.6529411764706
"356","R.Stevenson",2023,"NE",12,156,619,4,3.96794871794872,51.5833333333333,-12.8549788641084,-0.0824037106673613,3.90482002072501,51,38,238,0,74.5098039215686,194,857,4,71.4166666666667,145.7,12.1416666666667
"357","R.Stevenson",2024,"NE",15,207,801,7,3.8695652173913,53.4,-37.8557529582252,-0.182878033614615,4.34058201558579,41,33,168,1,80.4878048780488,240,969,8,64.6,175.9,11.7266666666667
"358","R.White",2022,"TB",17,136,522,1,3.83823529411765,30.7058823529412,-15.4210565237736,-0.113390121498335,4.19164197425382,64,54,326,2,84.375,190,848,3,49.8823529411765,152.8,8.98823529411765
"359","R.White",2023,"TB",19,299,1117,6,3.73578595317726,58.7894736842105,-44.7323713622597,-0.149606593184815,4.25733820970873,78,69,588,4,88.4615384615385,368,1705,10,89.7368421052632,295.5,15.5526315789474
"360","R.White",2024,"TB",16,145,614,3,4.23448275862069,38.375,-15.9716754819718,-0.110149486082564,4.56473795347084,59,53,407,6,89.8305084745763,198,1021,9,63.8125,203.1,12.69375
"361","S.Ahmed",2022,"MIA",7,17,67,1,3.94117647058824,9.57142857142857,0.194681458699051,0.0114518505117089,NA,6,4,53,0,66.6666666666667,21,120,1,17.1428571428571,22,3.14285714285714
"362","S.Ahmed",2023,"MIA",7,22,61,1,2.77272727272727,8.71428571428571,-0.23326447600266,-0.0106029307273936,NA,23,16,88,1,69.5652173913043,38,149,2,21.2857142857143,42.9,6.12857142857143
"363","S.Barkley",2022,"NYG",18,313,1426,12,4.55591054313099,79.2222222222222,-13.836461324969,-0.0442059467251407,4.15839096560845,85,64,415,0,75.2941176470588,377,1841,12,102.277777777778,322.1,17.8944444444444
"364","S.Barkley",2023,"NYG",14,247,962,6,3.89473684210526,68.7142857142857,-50.3739621219692,-0.203943166485705,3.84205235095764,60,41,280,4,68.3333333333333,288,1242,10,88.7142857142857,223.2,15.9428571428571
"365","S.Barkley",2024,"PHI",20,436,2504,18,5.74311926605505,125.2,30.8101262504954,0.0706654271800353,3.2338573606618,58,46,353,2,79.3103448275862,482,2857,20,142.85,455.7,22.785
"366","S.Brown",2022,"CAR",2,9,43,0,4.77777777777778,21.5,0.790135990569991,0.0877928878411101,NA,4,2,10,0,50,11,53,0,26.5,7.3,3.65
"367","S.Conner",2022,"JAX",5,12,42,1,3.5,8.4,-2.05222863185918,-0.171019052654932,NA,0,0,0,0,NA,12,42,1,8.4,10.2,2.04
"368","S.McCormick",2024,"LV",4,39,183,0,4.69230769230769,45.75,0.447879384562839,0.0114840867836625,3.2314202724359,7,6,29,0,85.7142857142857,45,212,0,53,27.2,6.8
"369","S.Michel",2022,"LAC",10,36,106,0,2.94444444444444,10.6,-2.80898014333798,-0.0780272262038327,NA,13,9,53,0,69.2307692307692,45,159,0,15.9,24.9,2.49
"370","S.Perine",2022,"CIN",19,109,452,3,4.14678899082569,23.7894736842105,-1.8976280101744,-0.0174094312860036,4.13794238415383,61,46,322,4,75.4098360655738,155,774,7,40.7368421052632,165.4,8.70526315789474
"371","S.Perine",2023,"DEN",17,53,238,1,4.49056603773585,14,-9.49174770995859,-0.179089579433181,NA,56,50,455,0,89.2857142857143,103,693,1,40.7647058823529,121.3,7.13529411764706
"372","S.Perine",2024,"KC",20,21,100,1,4.76190476190476,5,0.036444870663259,0.00173547003158376,NA,38,29,339,1,76.3157894736842,50,439,2,21.95,84.9,4.245
"373","S.Tucker",2023,"TB",3,15,23,0,1.53333333333333,7.66666666666667,-6.20917500916403,-0.413945000610935,NA,2,2,9,0,100,17,32,0,10.6666666666667,5.2,1.73333333333333
"374","S.Tucker",2024,"TB",11,50,308,2,6.16,28,10.127416212595,0.202548324251901,2.33889705882353,12,9,109,1,75,59,417,3,37.9090909090909,68.7,6.24545454545455
"375","S.Vaki",2024,"DET",4,6,14,0,2.33333333333333,3.5,-3.17468072671909,-0.529113454453181,NA,3,3,37,0,100,9,51,0,12.75,8.1,2.025
"376","T.Allgeier",2022,"ATL",16,210,1035,3,4.92857142857143,64.6875,10.2895796306982,0.04899799824142,4.0906223650579,17,16,139,1,94.1176470588235,226,1174,4,73.375,159.4,9.9625
"377","T.Allgeier",2023,"ATL",17,186,683,4,3.67204301075269,40.1764705882353,-21.9043098650159,-0.117765106801161,4.76599817217019,23,18,193,1,78.2608695652174,204,876,5,51.5294117647059,137.6,8.09411764705882
"378","T.Allgeier",2024,"ATL",17,137,644,3,4.7007299270073,37.8823529411765,4.43200247550139,0.0323503830328568,5.09878641269386,13,13,88,0,100,150,732,3,43.0588235294118,106.2,6.24705882352941
"379","T.Badie",2022,"DEN",1,1,0,0,0,0,-0.721431884914637,-0.721431884914637,NA,1,1,24,1,100,2,24,1,24,9.4,9.4
"380","T.Badie",2024,"DEN",4,13,94,0,7.23076923076923,23.5,1.75994376430754,0.135380289562118,NA,3,3,-2,0,100,16,92,0,23,10.2,2.55
"381","T.Benson",2024,"ARI",12,63,291,1,4.61904761904762,24.25,-4.97101015778026,-0.0789049231393691,10.0072903225806,6,6,59,0,100,69,350,1,29.1666666666667,47,3.91666666666667
"382","T.Bigsby",2023,"JAX",13,50,132,2,2.64,10.1538461538462,-12.3360569415672,-0.246721138831344,4.339375,4,1,6,0,25,51,138,2,10.6153846153846,24.8,1.90769230769231
"383","T.Bigsby",2024,"JAX",15,168,766,7,4.55952380952381,51.0666666666667,-0.84089315052433,-0.00500531637216863,3.73516348816199,12,7,54,0,58.3333333333333,175,820,7,54.6666666666667,129,8.6
"384","T.Chandler",2022,"MIN",1,6,20,0,3.33333333333333,20,-1.27408390166238,-0.21234731694373,NA,0,0,0,0,NA,6,20,0,20,2,2
"385","T.Chandler",2023,"MIN",13,102,461,3,4.51960784313725,35.4615384615385,0.693466081488367,0.00679868707341536,3.83384454482715,25,21,159,0,84,123,620,3,47.6923076923077,101,7.76923076923077
"386","T.Chandler",2024,"MIN",10,56,182,0,3.25,18.2,-10.4978651366344,-0.1874618774399,4.66680081300813,6,6,42,0,100,62,224,0,22.4,28.4,2.84
"387","T.Coleman",2022,"SF",2,12,26,1,2.16666666666667,13,-6.32914067406091,-0.527428389505076,NA,3,3,44,1,100,15,70,2,35,22,11
"388","T.Davis-Price",2022,"SF",5,34,99,0,2.91176470588235,19.8,-13.53276113639,-0.398022386364413,5.8130303030303,2,0,0,0,0,34,99,0,19.8,9.9,1.98
"389","T.Davis-Price",2023,"SF",1,6,21,0,3.5,21,-3.73455790895969,-0.622426318159948,NA,0,0,0,0,NA,6,21,0,21,2.1,2.1
"390","T.Davis-Price",2024,"PHI",1,3,7,0,2.33333333333333,7,-1.85095043038018,-0.616983476793393,NA,0,0,0,0,NA,3,7,0,7,0.7,0.7
"391","T.Ebner",2022,"CHI",7,24,54,0,2.25,7.71428571428571,-8.35346955159912,-0.34806123131663,NA,8,2,8,0,25,26,62,0,8.85714285714286,8.2,1.17142857142857
"392","T.Etienne",2022,"JAX",19,250,1296,6,5.184,68.2105263157895,-3.24082479741081,-0.0129632991896432,3.67892230764828,49,39,346,0,79.5918367346939,289,1642,6,86.421052631579,233.2,12.2736842105263
"393","T.Etienne",2023,"JAX",17,267,1008,11,3.7752808988764,59.2941176470588,-34.7945888526717,-0.130316812182291,4.43014812900579,73,58,476,1,79.4520547945205,325,1484,12,87.2941176470588,282.4,16.6117647058824
"394","T.Etienne",2024,"JAX",15,150,558,2,3.72,37.2,-26.5625049911323,-0.177083366607549,4.45368474630093,52,39,254,0,75,189,812,2,54.1333333333333,130.2,8.68
"395","T.Goodson",2023,"IND",6,13,87,0,6.69230769230769,14.5,-2.68572790917425,-0.206594454551865,2.66913043478261,9,6,34,0,66.6666666666667,19,121,0,20.1666666666667,18.1,3.01666666666667
"396","T.Goodson",2024,"IND",9,32,153,1,4.78125,17,2.6876475440641,0.0839889857520031,4.11196078431373,15,11,61,1,73.3333333333333,43,214,2,23.7777777777778,44.4,4.93333333333333
"397","T.Homer",2022,"SEA",8,19,74,0,3.89473684210526,9.25,-2.41903995090979,-0.127317892153147,NA,18,16,157,1,88.8888888888889,35,231,1,28.875,43.1,5.3875
"398","T.Homer",2023,"CHI",1,0,0,0,NA,0,0,NA,NA,1,0,0,0,0,0,0,0,0,0,0
"399","T.Homer",2024,"CHI",4,6,23,0,3.83333333333333,5.75,0.101053662772756,0.0168422771287927,NA,3,3,11,0,100,9,34,0,8.5,6.4,1.6
"400","T.Jennings",2024,"NE",2,13,33,0,2.53846153846154,16.5,-3.98449113772677,-0.306499318286675,NA,1,0,0,0,0,13,33,0,16.5,3.3,1.65
"401","T.Johnson",2022,"NYJ",10,30,160,1,5.33333333333333,16,-4.09428113913532,-0.136476037971177,NA,24,12,88,0,50,42,248,1,24.8,42.8,4.28
"402","T.Johnson",2023,"BUF",9,45,198,0,4.4,22,0.118733544447996,0.00263852320995547,NA,10,8,76,1,80,53,274,1,30.4444444444444,41.4,4.6
"403","T.Johnson",2024,"BUF",20,61,307,1,5.0327868852459,15.35,0.92630660450053,0.0151853541721398,NA,29,22,318,4,75.8620689655172,83,625,5,31.25,114.5,5.725
"404","T.Jones",2022,"NO",1,2,8,0,4,8,-0.351905251620337,-0.175952625810169,NA,2,2,12,0,100,4,20,0,20,4,4
"405","T.Jones",2022,"SEA",2,8,16,0,2,8,-3.18290235009044,-0.397862793761306,NA,6,3,18,0,50,11,34,0,17,6.4,3.2
"406","T.Jones",2023,"ARI",3,5,25,0,5,8.33333333333333,-0.12291451235069,-0.0245829024701379,NA,4,3,16,0,75,8,41,0,13.6666666666667,7.1,2.36666666666667
"407","T.Jones",2023,"NO",3,21,70,2,3.33333333333333,23.3333333333333,1.81077151207137,0.0862272148605414,4.65764705882353,6,4,21,0,66.6666666666667,25,91,2,30.3333333333333,25.1,8.36666666666667
"408","T.Jones",2024,"ARI",1,4,55,1,13.75,55,2.86425752664218,0.716064381660544,NA,0,0,0,0,NA,4,55,1,55,11.5,11.5
"409","T.McAllister",2024,"LV",1,2,11,0,5.5,11,-0.0164878789801151,-0.00824393949005753,NA,0,0,0,0,NA,2,11,0,11,1.1,1.1
"410","T.Pollard",2022,"DAL",18,214,1106,9,5.16822429906542,61.4444444444444,2.53646884842929,0.0118526581702303,3.52762857602875,61,44,394,3,72.1311475409836,258,1500,12,83.3333333333333,266,14.7777777777778
"411","T.Pollard",2023,"DAL",18,267,1061,7,3.97378277153558,58.9444444444444,-15.8206593234003,-0.0592534057056192,3.93447556055605,76,62,340,0,81.578947368421,329,1401,7,77.8333333333333,244.1,13.5611111111111
"412","T.Pollard",2024,"TEN",16,260,1079,5,4.15,67.4375,-27.2341533806673,-0.104746743771797,4.20800832409275,57,41,238,0,71.9298245614035,301,1317,5,82.3125,200.7,12.54375
"413","T.Sermon",2022,"PHI",1,2,19,0,9.5,19,2.30063952860655,1.15031976430328,NA,0,0,0,0,NA,2,19,0,19,1.9,1.9
"414","T.Sermon",2023,"IND",8,35,160,0,4.57142857142857,20,-1.11249512267622,-0.0317855749336062,3.01227272727273,6,3,13,0,50,38,173,0,21.625,20.3,2.5375
"415","T.Sermon",2024,"IND",14,56,159,2,2.83928571428571,11.3571428571429,-11.2412899742813,-0.20073732096931,5.35779945553539,19,16,99,0,84.2105263157895,72,258,2,18.4285714285714,53.8,3.84285714285714
"416","T.Spears",2023,"TEN",17,100,453,2,4.53,26.6470588235294,-0.736231872569715,-0.00736231872569715,3.3068,70,52,385,1,74.2857142857143,152,838,3,49.2941176470588,153.8,9.04705882352941
"417","T.Spears",2024,"TEN",12,84,312,4,3.71428571428571,26,-4.82757510938391,-0.0574711322545704,4.73034747838257,35,30,224,1,85.7142857142857,114,536,5,44.6666666666667,113.6,9.46666666666667
"418","T.Tracy",2024,"NYG",17,192,839,5,4.36979166666667,49.3529411764706,-20.7138662948379,-0.107884720285614,3.87622225694658,53,38,284,1,71.6981132075472,230,1123,6,66.0588235294118,182.3,10.7235294117647
"419","T.Williams",2022,"ARI",1,0,0,0,NA,0,0,NA,NA,1,1,5,0,100,1,5,0,5,1.5,1.5
"420","T.Williams",2022,"CIN",4,6,30,0,5,7.5,-0.613481856242288,-0.102246976040381,NA,3,2,30,0,66.6666666666667,8,60,0,15,8,2
"421","T.Williams",2023,"CIN",14,15,69,0,4.6,4.92857142857143,-2.09436621592613,-0.139624414395075,NA,9,7,10,0,77.7777777777778,22,79,0,5.64285714285714,14.9,1.06428571428571
"422","V.Jones",2023,"CHI",10,8,51,0,6.375,5.1,0.22051762137562,0.0275647026719525,NA,7,4,20,0,57.1428571428571,12,71,0,7.1,11.1,1.11
"423","V.Jones",2024,"CAR",1,1,0,0,0,0,-0.674527999013662,-0.674527999013662,NA,0,0,0,0,NA,1,0,0,0,0,0
"424","V.Jones",2024,"CHI",1,2,11,0,5.5,11,0.154408955597319,0.0772044777986594,NA,1,1,8,0,100,3,19,0,19,2.9,2.9
"425","W.Shipley",2024,"PHI",6,34,159,1,4.67647058823529,26.5,-2.46474559722358,-0.0724925175653993,4.419375,4,4,35,0,100,38,194,1,32.3333333333333,29.4,4.9
"426","Z.Charbonnet",2023,"SEA",16,108,462,1,4.27777777777778,28.875,-7.12166702465278,-0.0659413613393776,4.5376146572104,40,33,209,0,82.5,141,671,1,41.9375,106.1,6.63125
"427","Z.Charbonnet",2024,"SEA",17,135,569,8,4.21481481481482,33.4705882352941,-11.2815887777578,-0.0835673242796872,3.93870189494246,52,42,308,1,80.7692307692308,177,877,9,51.5882352941176,183.7,10.8058823529412
"428","Z.Evans",2023,"LA",4,9,19,0,2.11111111111111,4.75,-5.21281556869527,-0.57920172985503,NA,0,0,0,0,NA,9,19,0,4.75,1.9,0.475
"429","Z.Horvath",2022,"LAC",8,4,8,0,2,1,0.223257885401836,0.0558144713504589,NA,8,5,8,2,62.5,9,16,2,2,18.6,2.325
"430","Z.Knight",2022,"NYJ",7,85,300,1,3.52941176470588,42.8571428571429,-13.8350112856757,-0.162764838655008,5.77847211119152,14,13,100,0,92.8571428571429,98,400,1,57.1428571428571,59,8.42857142857143
"431","Z.Knight",2023,"DET",2,3,13,0,4.33333333333333,6.5,-0.205319102387875,-0.0684397007959584,NA,1,1,8,0,100,4,21,0,10.5,3.1,1.55
"432","Z.Moss",2022,"BUF",5,17,91,0,5.35294117647059,18.2,-7.11547991813859,-0.418557642243446,NA,8,7,27,0,87.5,24,118,0,23.6,16.8,3.36
"433","Z.Moss",2022,"IND",8,76,365,1,4.80263157894737,45.625,-3.09847832078866,-0.0407694515893245,3.41486933255793,5,4,12,0,80,80,377,1,47.125,47.7,5.9625
"434","Z.Moss",2023,"IND",14,183,794,5,4.33879781420765,56.7142857142857,-14.0308929556062,-0.0766715462054985,3.75805106646059,37,27,192,2,72.972972972973,210,986,7,70.4285714285714,169.6,12.1142857142857
"435","Z.Moss",2024,"CIN",8,74,242,2,3.27027027027027,30.25,-19.9914885412394,-0.270155250557289,4.99663849447825,27,23,187,1,85.1851851851852,97,429,3,53.625,81.9,10.2375
"436","Z.White",2022,"LV",11,17,70,0,4.11764705882353,6.36363636363636,-1.51255080098053,-0.0889735765282667,NA,0,0,0,0,NA,17,70,0,6.36363636363636,7,0.636363636363637
"437","Z.White",2023,"LV",13,104,451,1,4.33653846153846,34.6923076923077,-17.6899545091437,-0.170095716434074,3.5137490005626,19,15,98,0,78.9473684210526,119,549,1,42.2307692307692,73.9,5.68461538461538
"438","Z.White",2024,"LV",8,65,183,1,2.81538461538462,22.875,-36.2881887777818,-0.558279827350489,4.6167926916221,8,6,30,0,75,71,213,1,26.625,29.3,3.6625
